Microcosmos 31

  #####
###   #
#  *# ##
# #  * #
# *  # #
## #+  #
 #   $##
 ###  #
   ####

Best Solution 101/18
rruuLuullDllddRddrrdrUllluuRlluurrDuurrddLDDuurrddLdLUrruuluulldllddrd
dRluuluurrurrddrddllULURddrddlU


Microcosmos 29

   ####
 ###  #
## @$ #
# .$  #
# .* ##
# .$ #
##  ##
 ####

Best Solution 101/26
lddRUrruulDrdLLdlddrUrUUlDrdLuurruulDDldlluRuRlddrddlUluururDrruulDrdL
ulldlddrrrUULDrdLuurruulDrdLulD


Microcosmos 36

 ####
 #  #
##.@#
# .$#####
# $$ $  #
# ..    #
####  ###
   ####

Best Solution 108/28
ldlddrrruRdlllluurDRdrruLLUllddRRlluuruurDDDullddrUUdrrrddlUruLLullddr
RuulDrrrdrruLLLLdRluullddRUrrdLurrrdLL


Minicosmos 30

########
#   #  #
#      #
## #. .#
#    ###
# # * #
# $$# #
###  @#
  #####

Best Solution 168/51
llUUddrruuLuuullddRDrrddllUUrUUruLLulldRddlddRluuruuRRdrruLLLulDrrdddr
ddllUlluurRDrUUruLLulldRRRdddrddllUUdlluurRdrUUrruulDrdLuLLulldRRRDDll
UdrrurruulDrdLullulldRRRRurD


Microcosmos 22

     ####
 #####  #
 # $    #
## #.##$#
#  # @. #
#  .$ # ##
## ##.#  #
 #    $  #
 #  ######
 ####

Best Solution 208/57
dddllluurRurrrdddLLuUluuurrrDDlLdlUdlluuuRRDDrdddLLdlUUUrRurrrDDrdLLLu
UluuuRRurDDDlLdlUrrruullllldDldRuuurrrrrddlldddLLdlUUURRurrrDDrdLLLuUd
drruuuuullllldDldRRRuRDllluuurrrrrdddddllLLdlUUdrrrrruuuuulllllddldR


Microcosmos 25

     ####
  ####  #
  #..   #
### $@# ##
#  $ #.. #
# $   $  #
####  ####
   ####

Best Solution 153/38
urrdddLLdlUlUlldRRRRRuruullllDurrdLrurrddldllULrdrruruullllDurrrrddldl
luUluRRRlldddrrurrdLLLdlUUUrururDDulldlddrrrruLdllluuluRRRurDDulldlddl
UUddlluRRdrUU


Microcosmos 24

     #####
 #####   #
 # $ . # #
 # # $$  #
## ## # ##
#  $.$. #
# ##   ##
#  .@.##
#######

Best Solution 191/37
urruruuruulldlDururrddlddldlluRddlllluuruuuRRdrDDuuRuurrddLddLdLUddlll
luurRRDrdLuuRllluuurrdrDDuuRuurrddLddLLuululldddrRRDuuuRuurrddLLuLDrrd
dLdllulluuurRdrrrddlLLrrruullDurrddldlluRuululldddR


Microcosmos 34

 #########
 #  ##   #
##  *  # #
# .$#*@  #
#   *   ##
#########

Best Solution 100/29
dlLLUluurDRRllldldRRRRUrrruullDurrddldLLLLUluurDrRddllUdrruulLdlldRRuu
ulDrrrddrruLdlUrrruullDLddrruL
